11111111111111111
14444444444444441
14111111411111141
14111111411111141
14444444444444441
11111444444411111
11111444244411111
14444444444444441
14444441111144441
14444444433444441
11111111111111111