11111111111111111
14444444444444441
14111111411111141
14111111411111141
14111111444444441
14444444411111111
11111111211111111
14444434444444441
14111111111111141
14444444443444441
11111111111111111